111111111111111111111111111111111111111
1             2        2              1
1             2  3     2              1
1             2       2               1
1             22 2 2 2                1
1        1         1                  1
1        1         1                  1
1        1         1                  1
1        2         21111111111111111  1
1        2         22                 1
1        2         22                 1
1                                     1
1                                     1
1     22221111     22                 1
1           1      12     222111      1
1            1     12                 1
1            1     12                 1
1            1     12                 1
1              222212                 1
112222222222222222222212222222222222221
1                                     1
1                                     1
1              22            1111111111
1              21                     1
1                                     1
1                                     1
1   111222                            1
1                      11112222       1
1                                     1
1                                     1
1                                     1
1   11111111111                       1
1                                     1
1                                     1
1                                     1
1      2222222  222222222222222222 2221
1               2      2              1
1               2      2          4   1
1               2        2            1
111111111111111111111111111111111111111